# player
0,950,575,-90,0,0,0,0

# outer walls
2,640,10,0,0,0,0,1260
3,640,710,0,0,0,0,1260
3,10,360,90,0,0,0,700
3,1270,360,90,0,0,0,700

2,950,600,0,0,0,0,450
4,750,550,90,0,0,0,100
1,750,150,90,0,0,0,100

2,150,600,45,0,0,0,50
