# player
0,200,250,-90,0,0,0,0

# outer walls
2,640,10,0,0,0,0,1260
2,640,710,0,0,0,0,1260
2,10,360,90,0,0,0,700
2,1270,360,90,0,0,0,700

# center beam
3,640,210,90,0,0,0,400

# player spawn
2,200,290,0,0,0,0,100
2,200,390,0,0,0,0,100
2,150,340,90,0,0,0,100
2,250,340,90,0,0,0,100

# bouce pad
2,400,600,45,0,0,0,100

# goal roof
2,1100,600,0,0,0,0,340

# goal
1,1100,655,90,0,0,0,110