# player
0,640,360,-90,0,0,0,0

# outer walls
2,640,10,0,0,0,0,1260
2,640,710,0,0,0,0,1260
2,10,360,90,0,0,0,700
2,1270,360,90,0,0,0,700

#middle platform
2,330,360,0,0,0,0,640

#box

#corner

#goal