# player
0,400,100,-90,0,0,0,0

# outer walls
3,640,10,0,0,0,0,1260
3,640,710,0,0,0,0,1260
3,10,360,90,0,0,0,700
3,1270,360,90,0,0,0,700

2,340,250,0,0,0,0,300

2,940,250,0,0,0,0,300
2,1090,130,90,0,0,0,240

2,640,600,0,0,0,0,300

2,340,600,45,0,0,0,300

1,1200,360,90,0,0,0,200