# player
0,400,100,-90,0,0,0,0

# outer walls
3,640,10,0,0,0,0,1260
3,640,710,0,0,0,0,1260
3,10,360,90,0,0,0,700
3,1270,360,90,0,0,0,700

2,370,300,0,0,0,0,250
2,370,600,0,0,0,0,250

1,910,600,0,0,0,0,250


#bounce corners
2,550,650,45,0,0,0,185
2,730,650,-45,0,0,0,185

# center dividers
3,640,60,90,0,0,0,100
3,640,210,90,0,0,0,200