# player
0,100,300,-90,0,0,0,0

# outer walls
2,640,10,0,0,0,0,1260
2,640,710,0,0,0,0,1260
2,10,360,90,0,0,0,700
2,1270,360,90,0,0,0,700

#middle platform
2,330,360,0,0,0,0,640

#box
2,330,260,0,0,0,0,100
2,280,310,90,0,0,0,100
2,380,310,90,0,0,0,100

#corner
2,960,180,45,0,0,0,360
2,960,540,-45,0,0,0,360

#goal
1,100,535,90,0,0,0,348